1111111111111111111111111111111111111111
1E0000000000000C00000C000000000000000001
1010010100100000101001000000010100000001
1010010010101010001001000000010100000001
1P0000000C00C0000000000000000000C0000001
1010010010101010001111111100010100000001
1010010010101010001000000100010100000001
1C1001001C101010001CC1000100010100000001
1010010010101010001001000100010100000001
1000010010101010001001000100010100000001
1C1001001C101010001CC10000000101CCCCCCC1
1000010010101010001001000100010100000001
1000010010101010001001000100010100000001
1000010010101010001001000100010100000001
1000010010101010001001000100010100000001
1000010010101010001001000100010100000001
1000010010101010001001000100010100000001
1000010010101010001001000100010100000001
1000010010101010001001000100010100000001
1111111111111111111111111111111111111111