1111111110111
10010000000E1
1000011111001
1P00110C000P1
1111111111111