11111111111111
1C01000P000E11
10000101110011
1P001100000C11
11111111111111