1111111111111
1C010000100C1
110101P111001
1C0001E000001
1111111111111